1111111111111111
1000110000000111
1000110000000111
1005000000000111
1000002222222111
1000000500000111
1000011000000111
1000000000500111
1111000050000111
1000000000000111
1111111411111111
1000000000000111
1000600000300111
1111111111111111
1111111111111111
1111111111111111
