1111111111111
1000110000001
1000110000001
1000000000001
1000002222221
1000000000001
1000011000001
1000000000001
1111000050001
1000000000001
1111111411111
1000000000001
1000000000301
1111111111111
