1111111111111111
1000110000006111
1000110000000111
1050000000000111
1050002222222111
1050000000003111
1050011000000111
1000000000500111
1111000000050111
1055000000000111
1111111411111111
1000000000000111
1000000000000111
1111111111111111
1111111111111111
1111111111111111
